AHEAD	AH HH EH D
BACK	B AE K
COME	K AH M
FASTER	F AE S T ER
FULL	F UH L
GO	G OW
HALF	HH AE F
LEFT	L EH F T
MOVE	M UW V
RIGHT	R AY T
SPEED	S P IY D
STOP	S T AA P
TURN	T ER N
DOWN	D AW N
SLOW	S L OW
REDUCE	R IH D UW S
SLOWER	S L OW ER
SPEED	S P IY D
CORNER	K AO R N ER
CORRIDOR	K AO R AH D ER
TO	T UW
OUTSIDE	AW T S AY D
POINT	P OY N T
ONE	W AH N
